5EOX
EEEEEEEOEE
EEEEEEEEEO
EEEOEEEEOE
EEOEEEEEOE
EEEEEEOEEE
