5EOX
EEEOEEEEEE
EEEEEEEEEO
EEEOEEEEOE
EEOEEEEEOE
EEEEEEOEEE
