15EOX
EEEOEEEEEEEEEEEEEEEE
EEEEEEEEEOEEEOEEEEOE
EEEOEEEEOEEEOEEEEEOE
EEOEEEEEOEEEEEEEEEEE
EEEEEEOEEEEEEEEEEEEO
EEEEEEEEEEEEEEEEEEEE
EEEOEEEEEEEEEEEEEEEE
EEEEEEEEEOEEEOEEEEOE
EEEOEEEEOEEEOEEEEEOE
EEOEEEEEOEEEEEEEEEEE
EEEOEEEEEEEEEEEOEEEE
EEOEEEEEOEEEEEEEEEEE
EEEOEEEEEEEEEEEEEEEE
EEEOEEEEOEEEEEEEEEOE
EEEEEEOEEEEEEEEEEEEO
